Date,Description,Withdrawals,Deposits,Balance
01-Aug,Balance forward,,,25000
3-Aug,EFT,,20500,45500
5-Aug,CHQ#659,6050,,39450
6-Aug,CHQ#660,15000,,24450
13-Aug,NSF Cheque,6400,,18050
15-Aug,Service charge,130,,17920
24-Aug,CHQ#662,9680,,8240
26-Aug,EFT - office rent,1300,,6940
27-Aug,Deposit,,30600,37540
31-Aug,Interest,,55,37595
31-Aug,CHQ#664,6368,,31227