Date,Item,Debit,Credit,Balance
1-Aug,Balance,,,25000
3-Aug,Cheque #659,,6050,18950
5-Aug,Cheque #660,,5000,13950
10-Aug,Cheque #661,,750,13200
18-Aug,Cheque #662,,9680,3520
20-Aug,Cheque #663,,230,3290
27-Aug,Deposit,30600,,33890
29-Aug,Cheque #664,,6368,27522
31-Aug,Deposit,4435,,31957