Date,Item,Debit,Credit,Balance
1-Aug-12,Balance,,,25000
3-Aug-12,Cheque #659,,6050,18950
5-Aug-12,Cheque #660,,5000,13950
10-Aug-12,Cheque #661,,750,13200
18-Aug-12,Cheque #662,,9680,3520
20-Aug-12,Cheque #663,,230,3290
27-Aug-12,Deposit,30600,,33890
29-Aug-12,Cheque #664,,6368,27522
31-Aug-12,Deposit,4435,,31957